12 07 03
XXXXXXXXXXXX
XX...XM.G..X
XX...X.GG..X
XXJJJ.X.GXXX
X..J....XXXX
X...X...XXXX
XXXXXXXXXXXX
